$ 100 , 100
. . . . . . . . . . . . . . # . . . . . . . # . . . . . . . # . . . . . . . . . . . . # # . . . . . # # . . . . . . . . . . . . . # . . . . . . . # . . . . . . . . . . . . . . . . . # . . . # . . . .
. . . . . . . . . # # . # . . . . . . . . # . . . . . # . . . . # . . . . . . . . # . . . . . . . . . . . . . . . # . . # . . . . . . . . . . # . . . . . . . . . . . . . . . . . . . . . . # . . . . .
. # . . . . . . . . . . . . . . . . . . . . . . # . . # . . # . . # . . . . . . . . # . . . . . . . . . . # . . . . . . . . . . . . . . . . . . . . . # . . # . . . . . # . # . . . . . . . # . . # # .
. # . . . . . . . . . . . . . . . . . . . . . . # . . . . # . . . . . . . . . . . # . . . . . . . . . . . . # . . . . . . . . . . . . # . . . . . . . . . . . . . . . . . . # . . . . . . . . . . . # .
. . . . # . . . . . . . . . . . . . . # . . . . # . . . . # . . . . . . # . . . . . . . . . . . . . . . . . . # . . . . . . . . . . . . . . . . . . . . . . . . . # . . . . . . . . . . . . . . . . . .
. . . . . . . . . . . . . # . . . . . . . . . . . # . . . . . . . . . # . . . # . . . # # # . . . # # # . . . . . . . . . . . . . . . . . . . # . . . . # . . . . . . . # . . . . . . . . . . . . . . #
. . . . . . . # . . . . # # . . . . . . . . . . . . . . . . # . . . . . . . . # . . . . . . . # # . . . . # . . . . . . # . . . . . . . . . . . . # . . . . . . # . . . . . # . . . . . . . . . . . . .
. . # . # . . # # . . . . . . # . . . . . . . # . . . . . . . . . . . . . . . . . . # . . . . . # # . . . . # . . . . . . . . . . . . . # . . . . . # . . . . . . . . . . . . . . . . . . . . . # # . .
. # . . . # . . . . . . . # . . . . . . . . . . . . . . . . # # . # . . . # . . . . . . . . . . . . . . # . . . . . . . . . . . . . . . . . . . # # . . . . . . . . . . . . . . . . . . . # . . # . # .
. . . . . . . . . . . . . . . . . . . # . . . . . . . . . . . . . . . . . . . . . . . . . . . . . . . . . . . . . . # . . . . . # . . . . . . . . . . . . . . . . . . . . . . . . . . . . . . . . . . .
. . . . . . . . . . . . . . . . . . . . . . . . . . . . . # . . . . . # . . . . . . . # . . # . . . . . . . . # . . . . . . . # . . . . . . . . . . . . . # . . . . . . . . . # # . . # # . . . . . . .
. . # . . . # . . . . . . . . . . . . # . . . . . . # . . . . . . . . . . . . . # . # . . . # . . . . . . . . . . . . . . . . . . . . . . . . . . . . # . . # # # . . . . # . . . . # . . . . . . . . #
. . . . . . . . . . . . . . . # . . . . . . . # . . . . . . . . . . . . . . . . . . . # . . . . . . . . . . . # . . . . . . . . . . . . . . . . . . . . . . . . . . . . . . . . . . . . . . # . . . . .
# . . . . . . . . . . . . . . . . . . . . . # . # . . . . . . . . . . . # . . . . . . . . . . . . . # . . . . . . . . . # . # . . . . . # . # . . . . . . . . . . . . . . . . . . . . . . # . . . . . .
. . . . . . . . . . . . . . . . . . . . . . . . . . . . . . . . . . . . . . . . . . . . . . . . . . . . . . . . . . . # . . . . # . . . . # . # . . . . . . . . . . . . # . . . . . . . . . . . . . . .
. . . . # . . . . . . . . . # . . . . . . . # . . . . . . . . . . . # # . . . . # # # . . . . . . . . . . . . . . . . . . . . . . . . . . # . . . . . . . . . . . . . . . . . . . . # . # . . . . . . .
. . # # . . . # . . . # . . . . . . . . . . . . . . . . . . . . . . . . . . . . . . . . . . # . . . . . . . . . . . . . . . . . . # . . # # . . . . . . # . # . . . . . . . . . . . . . . . . . . . . .
. . . . . # . . . . . # # . . . . . . . . . . . . . . . . . . . . . . . . . . # # # . . # . . . . . . . # . . . . . . . . . . . . . . . . . . . . . . . . # . # . . . . . . . . . . # . . . . . . . . #
. # . . . . . . . . . . . . . . . . . . # . . . . # . . # . # . . . . . . . . # . . . . # . . . . . . . . . . # . . . . . . . . . . . . . . # . . . . . . . . . . . . . . . . . . . . . . . . . . . . #
. . . . . . . . . . . . . . # . . . . . . . . . # . . . . # . . . # . . . . . . . . . . . . . . . . . . . # . . . . . . # . . # . . . . . . . . . . . . . . . . . . # . . . . . # . . . . . . . # . . .
. . . . . . . . . . . . . # . . . . . . . . . . . . . . . # # . . . . . . . . . . . . # . . . . . . . . . . . . . . . . . . # # . . . . . . . . . . . . # . . . . . . . . . # . . . . . . . # . . . . .
. . # . . . . . # . . # # . . . . . . # . . . # . . . . . . # . . . . . . . . . . . . . # . . . . . . . . . . . # . . . . # . . # # . . . # . . . . . . . # . . . . . . . . . . . . . # . . # . . # . .
. . . # . . . . . . . . # . . . . . . . . . . . . # . . . . . . . . . . . . . . . # . . . . . . . # # . . . . . . . . . . . . . . . . . . # . . . . . . . . . . . . . . . . . . . # . . . . # . . . # .
. . . # . . . . . . . . . . . . . . . . . # . . . . . . . . # . . . . . # . . . . . . . . . # . # # . . . . . . . . . . . . . . . . # . # . . . . . . . . . . . . . . . . . . . . . # . . . . . . # . .
. # . . . . # . . . . . . . . . . . . . . . . . . . . # . . . . . . . . . . . . # . . . . . . . . . . . . . . . # . . . . . . # . . . . . . . . . . . # # . . . . . # . . . . . . . . . . . . . . # . .
. . . . . . . . . . . . . . # . . . . . . . . . . . . . . . . # . # . . . . . . . . . . . . . . . . . . . . . . . # . . . . . . . . . . . . . # . . . . . . . . . . # . . . . . . . . . . # . . # . . .
. . . . . . . . . . . . . . . . . . . . . . . . . . . # # . . # . . . . . . . . . . . . . . . . . . . . . . . . . . . . # . . . . . . # . . # . . . . . . . . . . . . . . . # . . . . . . # . . # # . #
. . . . . . . # . . # . . . . . . . . . . . . . . . # # . . . . . . . . . # . . . . # . . . . . . . . . . . . . . # . . . . . . . . # . . . # . . . . . . . . . . . . . . . . . . # . # . . . . . . . .
# . . . . . . . . . # . . . . . . . . . . . . . . . . . . . . . . . . . . . . . . . . . . . . . . . . . . . . # . . . # . . . . . . # . . . . . . . . . . . # . . . . . . # . . . . . # # # . . # . . .
# . . . . . . . . # . . . . . . . . # . . # . . . . . . . . . . . # . . . . . . . . . . . . . . . . . . . . . . . . . . . . . # . . # . . . . . . . . . . . . . . . . . . . # . . . . . . # . . . # . .
. . . # . . . . . . . . . . # . . . . . . # . . . . # . . # . . . . # . . . . . . . . # . . . . . . # . . # # . . . . . # . . . . . . . . . . . . . . . . . . . . . . . . . . . . . . . . . . . . . . .
. . . . . . . . . . . . . . . . . . . . . . . . . . # # # . . . . . . . . . . . # . . . . . . . . . . . # . . . . . . . . . . . . . . . . . # # . . . . . . . . . . . . . . . . . . # . . . . . . . . .
. . . . . . . . . . . . . . . . . . . . . . . . . . . . . . . . . . . . . . . . . # . . . # . . . . . . . . . . . . . . . . . . . . . . . . . # . . . . . . . . . . . . . . . . . . . . . . # . . . # .
. . . . . . . . . . . . . . . . . . . . . # . . . # . . . . # . . . . . . . . . . . . . . . # . . . . . . # . . # . . . . . . . . # . . . . # . . . . . . # . . . . . . # . . . . . . . . . . . . . . .
. # . # # . . . . . . . . . . . . . . . . . . # . . . . . # . . . . . . . . . . . . . # . . . . # . . . # . . . . . . . . . . . . . . # . . . . . . . # . . . . # . # . . . . # . . . . # . . . . . . .
. . . . . . . . . # . . . . . . . . . . . . . . . . . . . . . . . # . . . . . . . . . # . . . . . # . . . . . . . . # . . . . . . . # . . . . . . # . . . # . . . . . . . . . . . . . . # . . . . . . .
. . . . . . . . . . # . . . . . . . . . . . . . . . . . . . . . . . . # . . . . . . . . . . . . # # . . . . . . . . . . . . . . . . . . . . . . . # . . . . . . # . . . . . . . . . . . . . . # . . . .
. . # . . . . . . . . . . . . . . . . . . . . . . . . . . . . . # . . . . . . # . . . . . # . . # . . . . . . . . . . . . . . . . . . . . . . . . . . . . . . # . . # . . . . . # . . . . . . . . . . .
. # # . . . # . . # . # . . . . . . . . . . . . # . . . . . . . . . . . . . # . . . . . . . . . . . . . . . . . . . # . . . . . . . . . . . . . . . . . . . . . . . . . # . . . # . . . . . . . . . . .
. . . . . . . . . . . . . . . . . . . . . . . . . . . . . . . . . . . . # . . . # # . . # . . . . . . . . . . . . . . . . . . . . . . . . . . . . . . . . . . . . . . . . . . . . . . . . . # # . . . .
. . . . . . . . . # . . . . . . . . . . . . . . . . . . # . . . . . . . . . . . . . . . . . . . # . . . . . . . . . . . . . # . . . . . . . . . . . . . . . . . . . . . # . . . . # . . . # . . . . . .
. . # . . . . . . . . . . . . . . . . . . . . . . # . . . . . . . . . . # . . . . . . . . # . . . # # . . . . . . # . . . # # . . . . . # . . . . . . . # . . # . . . . . . . . . . # . . # . . # . . #
. . . . . . . . . . . . . . . . # . . . . . # . . . . . . . . . . . . . . . . . . . . . . # . . . . . . . . . . . . . . . # . . . . . . . . . . . . . . . . . . . . # . . . # # # . . . . . . . . . . .
. . # . . . . . . . # . . . . . . . . . . . . . . . . . . . . . . . . . . . . . . . . . . # . . . # . . . . . . . . . . . . . . . . . . . . . . . . . . . . # . . . . . . . # . . . . . . . . . . . . .
. . # . . . . . . . . . . . . . . . . # . . . . . . . . . . . . . . . . . . . . . . # . # . . . . . . . . . . . . . . . . . # . . . . . . . . . . # . . . . . # . . . . . . . . . . . . # . . # . . . .
. . # . . . . . . . . . . . . . # . . # # . . . . . . . . . . # . . . . . . . . . # . . . . . . . . . . . . . . . . . . . . . . . . . . # . . . . . . . . . . . . . . . . . . . . . . . . # # . . . . .
. . . . . . . . . . . . . . . . . . # . . . . . . . . . . . . . . . # . . . . . . . . . # . . . . . . . . . # . . . . # . # . . . . . . . . . # . . . . . . . # . . . . . . # # . . . . # . . . . . . .
. . . . . . . . . . . . . . . . . . . . . # . . # . . . # . . . . . . . . . # . . # . # . . # . . . . . . . . # . . . . . . . . . . . . . . . . . . . # . . . . . . . . . . . . . . . . . . # . . . . .
. . . . . . # . . . . . . . . . . . . . . . . # . . . . # . . . . . . . . . . . . . . . . . . # # . . . . . . . # . . . . # . . . . . . # . . . . . . . . . . . . . . . . . # . . # . . . . . . . . . .
. . . # . . . # . . . . # . . . . . . . . . . . # . . . . . . . . . . . . . . . . . . # . . . . . . . . . . . . . . . . . # # . . . . . . . . . . . . . . . . . . . . . . . . . . # . . # # . . . . . .
. . . . . . . . . . # . . . . . . . . # . # . . . . . . . . . . . . . . . # . . . . # . . . . . . . . . . . . . # . . . . . # . . . . . . . # . . # . . . # . . . . . # . . . . . . . . . . . . . . . .
. . . . . . . . . . . . . . . . # . . . . . . . . . . . . . . # . # . . . . . # . . . . . . . . . . . . . . . # # # . . . . . . . . . # . . . # . . # . . . . . . . . . # # . . . . # . . . . . . . . .
. . . . . # . . # . . . . . . . . . . . # # . . . . . . . . . # . . . . # # . . # . # . . . . . . . . # . . . . # . . . . . . . . # # # . . . . . . . . . . . . . . . . . . . # . . . . . . . . . . # .
. . . . . . . . . . . . . . . . . . . . . . . . . . . . . . . . . . . . . . . . . . . # . . . . . . . . . . . . . . . . . . . . . # . . . . . . . . . # . . . . . . . . . . . . . # # . . . . . # # . .
. . . . . . . . . . . . . . . . . . # . . . . . . . . . . . . . . . . . . # . . . . . . . . . . # . . . . . . . # . . . # # . . . . . . . . . # # . . . . . . . . . . . . . . # . . . . . . . . . . . .
. . # . . . . . . . . . . . . . . . . . . . . . # . . . . . . . # # . # . . . . . . . . . . # . . # . . . . . . # . # . . . . . . . . . . . . . . . # # . . . . . . . . . . . . . # . . . . . # . . . .
. . . # . # . . . . . . . # . . . . . . . . . . . . . . . . # . . . . . # . . . . . . . . # . . . . . . . . # . # . # . . . . . . . . . # . . . . . . . . . # . . . . . . . . . . . . . . . . . . . . .
. . . # . . . . . . . . # . . # . # . . . . . . . . . . . # . . . . . . . . . . . . . . . . . . . . . . . . . . . . . . . . . . . # . . . . . . . . . . . . . . . . # . . . . . . . . . . . . . # . . .
. . . . . . . . . . . . . . . # . . # # . . . . . # # . . . . . . # . . . . . . . . . . . . . . . . . . . # . . . . . . # # . . . # . # . . . . . # . . . . . . . . . # # . . . # . . . . . # . . . . .
. # . . . . . . . . . . . . . . . . . . . . . # . . . . . . . . . . . . . . . . # # . . . . . . . . . . . . . . . . . . . . . . # . . . . . . . . # . . . . . . . . . . . . . . . . . # . . . . # . . .
# . # # # . . . . . . . . . # . . . . . # . . . . . . . . . . . . . . # . . . . . . . . . . . . # . . # . # . . . . . . # . . . . . . . . . . . . . . # . . . . . # . . . . . . . . . . . . . . . . . .
. . . . # # . . . . . . . . . . . . # . . . . . . . . # . # . . . . . . . . . . . . . . . . # . . . . . . . . . . . . . . . . . . # . . . . . . . # . . . . . # . . . . . . . . # . . . . . . # # . . .
. . . . . . . . . # . . . . . # . . . # . # . . . . . . . . # . . . . . . . . . . . . . . . . . . . . . . . . . . . . . . . . . . . . . . . # . . . . . . . # . . . . . . . . . . . # . . . . . . . # .
. . . . . . . . # # # . . . . . . . . . . . . . . . . . # . . . . . # . . . . . . . . . . . # . . . . # . . # # # . . . . . . . # . . . . . . . . # . # . . # . . . . . . . . . . . . . . . . . . # . #
. . . . . . . . . . . # . . . # . . . . . . . . . . # # . . . . . . . . . . . . . . . . . # . . . . . . . . . . . . . . . . . . . . . . . . . . . . . # . . . . . . . . . . . . . . . . . . . . . . . .
. # . . . # . # # . . . . . . . . . . . . . . . . . . . . . . . . . . . . . . . . . . . . # . . . . . . . . . . . # . . . . . . . . . . . # . . . . . . . # . . . . . . . . . . # . . . . . . # . . . .
. . . . . # . . . . # . . . . . . . . . . . . . . . . . . . . . . . . . . . . . . . # . . . # . . . . . . . . . . . . . . . . . . . . . . . . . . . . . . # . # # . . . # . . . . # . . . . . . . . . .
. . # . . . . . . . . . . . . . . . # . . . . . . . . . . . . . # # . . . . . . . . . . . . . . . . . . . . . . . # . . . . . . # . . . . . . . . . . . . . . . . . . . . . . . . . . . . . . . # . # .
. . . . . . . . . . . . . . . . . . . . . . . . # . . . . . . . . . . . . . . . . # . . . . . . . . . # . . . . . . . . . . . . . . # . . . . . . . . . . . . . . . . . . . . . . . . . # # . . . . . .
. . . # . . . . . # . . . . . # . . . . . . . . # . . # . . . # . . . . . . . . . . . . # . . . . . . . # . # . . . . . . . # . . . . . . . . . . . . # . . . . . . . . . # . . # . . . . . . . . . . #
. . . . . . . . . . . . . . . . # . . # . . . . . . . . . . . . . . . # . . . . . . . . . . . . . # . . . . . . . . . # . . . . . . . . . # . # # . . . . . . . . . . . . . . . . . . . . . . . # . . #
. . . . # # . # . . . # . # . . . . . . . . . . . . . . . . . # . . . . . . . . . . . # . . . . . . . . . . . . . . . . . . . . . . # . . . . . # . . . . . . . . . . . . . # . . . . . . . . . . . . .
. . . . . . . . . # . . . . . . . . . . . . . . . . . . . . . . . . . . . . . . . . . . . . . . . # . . # . # . . . . . . . . . . . . . . . . . . . . . . . . . . # . . . . . . . . . . . . # . . . . .
. . . # . . # . . . . . . . . . . . . . . . # . . . . . . # . . . . . . . . . . . . . . # . . . . . # . . . . . . . . . . . . # # . . . . . . . . . . . . . # . . . . . . . . . . . . . . # . . . . . .
. . . . . . . . . . . . . . . . . . . . . . . . . . . . . . . . . . . . . # . . . . # . . . . . . . . . # . . . . . . . . . . # . . . . . . . . . . . . . . . . . . . . . . . . . . . . . . . . # . . .
. . # . . . . . . . . . . . . . . . . . . . . . . . . . . . . . . . . . . . . . . . . . # . . . # . . . . # . . . . . # # . . . . . . . . . . . . . . . . . . . . . . . . . . . . # . . . . . . . . . .
. . . . . . . . . . . . . . . . . . . . . . . . . # . . . . . . . . . . . . # . . . # . . . . . . . . . . . . . . . . . . . # # . . . . . . . . . . . . # . . . . . . . . . . . . . . . . . . . . . . .
. # . . . . . . # . . . . . . . . . . . . . . . . . . . . # . . . . . . . . . # # . . . . # . # . . . . . . . . . . . . . . . . . # . . # . . . . . . . . . . . # . # . . . . . . # . . . . . . . . . #
. . . . . . . . . . # . . . . . . . . . . . . . # . # . . . . . . . . . . . . . . . . . . . . . # . . . . . . . . . . . . . . . . . . . . . . . . . . . . . . # . . # . . # . . # . # . . . . . . . . .
. . # . . . . . . . . . . . . . . . # . . . . . . . . . . . . . . . . . . . . . . . . # . . . . . . # . . . . . . . . . . . . # . . . . . . # . . . . . . # . . . . . . . . . . . # . . . . . # . . . .
. . . . . . . . . . . . . . . . # . . . . . . . . . . . . # # . . . . . . . . . . . . . . . . . . . . . . . . # . . . # . . . . . . . . . . . . # . . . . # . . . . . . . . . . . # . # . . . . . . . .
# . . . . . . . . . . . . . . . . . . . . . . . . . . . . . . . . . . . . . . # . . . . # . . . . . . . . . . # . . . . . . . . . . . # . . . . . . . . . . . . . . . . . . . . . . . . . . . . . . . .
. . . . . . . . . . . . . . . . # . . . . . . . . . . . . . . . . . . . . . . . # . . . . . . . . . . # . . . . . . . . . . . . . . . # . . . . . . . . . . . . . . # . . . . . . . . . . . . . . . . .
. . . . . . . # . . . . . . . . . . . . . . . . . . . . . . . . . . . . . . . . . . . . . . # . . # . . . . # . . . # . . . . . . . . . . . . . . . . . # . . . . . . . . . . . . # . . . . . . . . . .
. . # . . . . . . . . . . # . . . . . # . . . . . . . . . . . . . # . . . . . # . . . . . . # . . . . . . . # . . . . . . . # . . # . . . . . . . . . . . . . . . . . . . . . . . . . . # . . . . . . .
. . . . . . . . . . . . . . . . . . . . . . . . . . . # . . . # . . . . . . . . . . . . . # . . . . . . # . . . . . . . . . . . . . . . # . . . . . . . . . . . . . . . . # . . . . . . . . . . . . . .
. . . . . . # . # . . . . . . . . . . . . . . . . . . . . . . . . # # . . . . . . . . . . . . . . . . . . . . . . . . . . . . . . . # . . . . # # . . . . # . . . . # . . . # . # . . . . . # . . . . .
. . . . . . . . . . . . . . . . . . . # . # . # . . . . # . . . . . . . . . . . # . . . . . # . # . . . . . . . . # . . . . . # . . . . . . . . . . . . . . . . . . . # . . . . # . . # . . . # . . . .
. . . . . . . . . . . . . . . . . . # # . # . . . . . . . . . . . . . . . . . # . . . . . . . . . . . # . . . . . . . # # . . # . . . # . . . . . . . . . # # . . . . . . . . . # . . . . . . . . . . .
. # . . . . . . . . . . . . . . . . . . # . . # . . . . . . . . . . . . . . . . . . # . . . . . . . . . . . . # # # . . . . . . . . . . . . . . . . . . . . . . . v . . . # # . . . . . . . . . . . . #
. . . . . # . . . . . . . . . . . . . . . . . . . . . # . . . . . . # . . . . . # . # . . . . . . . . . . . . . . . . . . . . . . . . . . . . . . . . # . . . . . . . . . . . # . . . . . . . . . . . .
. . . # . . . . . . . . . . . . . . . . . # . # . . . . . . # . . # . . . . . . . . . # . # . . . . . # . . . . . . # . . . . . . # . . . # . . . . . . . . . . . . . . . . . . . . . . . . . . . . . .
. . # . . . . . . # . # . . . # . . . . . . . . . . . . # # . . . . . . . . . . . . # . # . . . . . . # . . . . . . . . . . . . # . . . . . . . # . . . . . # . . . . # . . . . . . # . . . . . . # . .
. . . . . . . . # . . . . # . . . . . . . . . . . . . . . . . . . # . . # . # . # . . . . . . # . . . . . # . . # # . . . . . . . . . . . . . . . . . . . . . . . . . . . . . # . . . . . . . . # . . .
. . . . . . . . . . # . # . . . . . . . # . . . . . . . . . . . . . . . . . . . . . . . . . . . . . . . . # . . . . . . . . . . . . . . # . . . . . . . . . . . . . . . . # . . . . . . . . . . . . . .
. . # . . # . . . . . . . . . . . . . . . . . . . . . . . . # . . . . . # . . . . . . . . # . . . # . . . # . # . . . . . . . . . . . . . . . . . # # . . . . . . # . . . . . . . . . . . . . . . . . .
. . . . . . . . . # . # . . . . . . . . . . . . . . . . . # . . . # # . . . . . . . . . . . . . . . . . . . . . . . # . . . . . . . . . . . . # . # . # . # . . . . . . . . . . . . . . . . . . . . . .
# # . . . . . . . . . # . . # . . . . . . . . . . . . . . . . # . . . . # . . . . . # . # . . . . . # . . . . # # . . # . # . . # . . . . . . . . . . . . . . # . . # . . . . . # . . . . . . . . . . .
. . . . . . . . . # . # . . . . . # . . . . . . . . . . . . # . . . . # # . . . . . # . # . . # . . . . . . . . . . . . . . . . . . . . . . . . . . . . . . # . . . . . . . . . . # . . # . # . # . . .
. . . . . . . . . . # . . . . . . . . . . . . . . . . . . . . . . . . . . # . . . . . . . . . . . # . . . . . . . # . . . . . . # . . . . # . . . . . . . . . . . . . . . . . # . # . . . . . . . . . .